#############################
#            ###            #
# #### ##### ### ##### #### #
# #### ##### ### ##### #### #
#                           #
# ###### # ####### # ###### #
#        #   ###   #        #
######## #         # ########
_______# ####   #### #_______
|        #         #        |
-------# #         # #-------
######## ########### ########
#            ###            #
# #### ##### ### ##### #### #
#    #                 #    #
#### # ## ######### ## # ####
#      ##    ###    ##      #
# ########## ### ########## #
#                           #
#############################